%%%%%%%%%%%%%%%%%%%%%%%%%%%%%%%
%                            P%
% %%%%%%%%% %%%%%%% %%% %     %
% %   % %      %      % %     %
%   %%% % %%%% % %%%%   %%%   %
%%% % % % %      %  % %   % %%%
%   % %%% % %%% %%% % %%% %   %
% %%%       %     %       %%% %
%     %%%%% %%%%%%% % %%% %   %
%%%%      %    %    % %   % %%%
%   %%% % %%%% % %%%% % %%%   %
%       %      %      %     % %
%     %%%%% %%%%%%% %%% % %%% %
%.                  %   %     %
%%%%%%%%%%%%%%%%%%%%%%%%%%%%%%%
