%%%%%%%
%    P%
%     %
% %%  %
%% %  %
%.    %
%%%%%%%
